11 11 11 11 11 11 11 11 11 11 11 11 11 11 11 11 11 11 11 11 11 11 11 11 11 11 11 11 11 11 11 11 11 11 11 11 11 11 11 11 11 11 11 11 11 11 11 11 11 11 11
11 11 11 11 11 11 11 11 11 11 11 11 11 11 11 11 11 11 11 11 11 11 11 11 11 11 11 11 11 11 11 11 11 11 11 11 11 11 11 11 11 11 11 11 11 11 11 11 11 11 11
11 11 11 11 11 11 11 11 11 11 11 11 11 11 11 11 11 11 11 11 11 11 11 11 11 11 11 11 11 11 11 11 11 11 11 11 11 11 11 11 11 11 11 11 11 11 11 11 11 11 11
11 11 11 11 11 11 11 11 11 11 11 11 11 11 11 11 11 11 11 11 11 11 11 11 11 11 11 11 11 11 11 11 11 11 11 11 11 11 11 11 11 11 11 11 11 11 11 11 11 11 11
08 10 09 07 09 10 07 07 10 09 07 05 08 08 07 10 08 10 09 07 09 10 07 07 10 09 07 05 08 08 07 10 08 10 09 07 09 10 07 07 10 09 07 05 08 08 07 10 10 10 10
06 06 06 06 06 06 06 06 06 06 06 06 06 06 06 06 06 06 06 06 06 06 06 06 06 06 06 06 06 06 06 06 06 06 06 06 06 06 06 06 06 06 06 06 06 06 06 06 06 06 06
06 06 06 06 06 06 06 06 06 06 06 06 06 06 06 06 06 06 06 06 06 06 06 06 06 06 06 06 06 06 06 06 06 06 06 06 06 06 06 06 06 06 06 06 06 06 06 06 06 06 06
03 02 05 02 04 05 02 03 05 05 03 04 02 04 03 02 03 02 05 02 04 05 02 03 05 05 03 04 02 04 03 02 03 02 05 02 04 05 02 03 05 05 03 04 02 04 03 02 05 03 03
01 01 01 01 01 01 01 01 01 01 01 01 01 01 01 01 01 01 01 01 01 01 01 01 01 01 01 01 01 01 01 01 01 01 01 01 01 01 01 01 01 01 01 01 01 01 01 01 01 01 01
12 13 13 12 13 12 13 13 12 12 13 12 12 12 13 12 12 13 13 12 13 12 13 13 12 12 13 12 12 12 13 12 12 13 13 12 13 12 13 13 12 12 13 12 12 12 13 12 13 12 12
00 00 00 00 00 00 00 00 00 00 00 00 00 00 00 00 00 00 00 00 00 00 00 00 00 00 00 00 00 00 00 00 00 00 00 00 00 00 00 00 00 00 00 00 00 00 00 00 00 00 00
13 12 12 13 12 13 13 12 12 13 13 13 13 12 12 13 13 12 12 13 12 13 13 12 12 13 13 13 13 12 12 13 13 12 12 13 12 13 13 12 12 13 13 13 13 12 12 13 12 13 13